Eos -- Euryalus
Danae -- Great-Ajax
Ariadne -- Thoas
Cassandra -- Idaeus
Iphis -- Strife
Eileithyia -- Meges
Medesicaste -- Leonteus
Dione -- Oeneus
Aethra -- Iris
Chrysothemis -- Helenus
Europa -- Sthenelus
Charis -- Eurypylus
Hippodameia -- Idomeneus
Enyo -- Antilochus
Chryses -- Menelaus
Hecamede -- Machaon
Ate -- Cebriones
Clytia -- Phoenix
Polymele -- Asteropaeus
Polydora -- Peleus
Laothoe -- Pandarus
Eurynome -- Talthybius
Eeriboea -- Polydamus
Laodice -- Glaucus
Althea -- Hades
Briseis -- Patroclus
Clymene -- Eumelus
Iphianassa -- Diomedes
Dia -- Agenor
Demeter -- Menestheus
Artemis -- Apollo
Astyoche -- Peneleos
Marpessa -- Deiphobus
Astyocheia -- Aeneas
Niobe -- Polypoetes
Rhea -- Poseidon
Chryseis -- Odysseus
Leto -- Hermes
Cleopatra -- Acamas
Night -- Anchises
Deipyle -- Tydeus
Aphrodite -- Ares
Semele -- Thrasymedes
Hera -- Zeus
Philonoe -- Bellerophon
Hypsipyle -- Teucer
Laodice -- Laomedon
Athene -- Achilles
Theano -- Meriones
Andromache -- Hector
Helen -- Paris
Thetis -- Hephaestus
Agamede -- Nestor
Abarbarea -- Lesser-Ajax
Hesione -- Heracles
Hecuba -- Priam
Tethys -- Sleep
Laodameia -- Sarpedon
Alcmene -- Agamemnon
Periboea -- Automedon
Anteia -- Zephyr
Themis -- Xanthus
